1111111111111111111111111111111111
1P0000000000000000000000000C000001
1000000000000000000000000000000001
1000000000000011100111111111000001
1000000000001110000110000111000001
10C0000000111000000100001110000001
10000000111000000E0000111000000C01
1000001110000000000111100000000001
1000111111111111100111100001000001
1000000000000011100111000011000001
1000000000000011100111111111000001
100000C000000011100000000000000001
1000000000000000000000000000000001
1C000000000000000000000000000000X1
1111111111111111111111111111111111