111111111111111
1P00000000000C1
101010101010101
100000000000001
1C1010101010101
100000000X00001
101010101010101
100000000000001
101010101010101
100C00000000001
101010101010101
10000X000000001
101010101010101
100000000000001
10101C101010101
1000000000000E1
111111111111111